AAAAAAAAAAAAAAAAAAAAAAAAAAAAAAAA
PPBPPPPPBPPPPPGPPGPPPPPPPPGPPGPP
PPPPPGPPPPPPPPPPPGPPPPPGPPGPPGPP
PPPPPPPPGPPGPPPPPPPPGPPGPPPPPPPP
PPRPPPPPGPPGPPGPPPPPGPPGPPPPPPPP
SSSSSSSSSSSSSSSSSSSSSSSSSSSSSSSS